* Nth fibonnaci number - codestudio - AmazonMicrosoftOYO RoomsSnapdealMakeMyTripGoldman SachsMAQ SoftwareAdobe
no simalar qeustions found
70. Climbing Stairs - FlipkartAmazonMicrosoftOYO RoomsAdobe
746. Min Cost Climbing Stairs - no qusestion available in gfg 
322. Coin Change - PaytmFlipkartMorgan StanleyAccoliteAmazonMicrosoftOYO RoomsSamsungSnapdeal
* Maximum sum of non-adjacent elements- codestudio - PaytmFlipkartAmazonOYO RoomsFactSetWalmartAdobeOxigen WalletYahoo
no simalar qeustions found
198. House Robber - Medium - tmFlipkartAmazonOYO RoomsWalmartGoogle
1547. Minimum Cost to Cut a Stick - Hard - AmazonMicrosoftOYO Rooms
* above question is almost similar to B L, but the numbers are passed as sets,
  and not as individual numbers, need to solve in a little different way.
* Count derangements - no question available in gfg 
no simalar qeustions found
* Ninja And The Fence - codestudio - no compaines yet
above simalar to bellow
Paint Fence - leetcode Premium - no compaines yet

Bellow problems are the variants of Knapsack problem from gfg and codestudio
NOTE: tere are no question related to Knapsack in leetcode
* 0 1 Knapsack - codestudio - Twitter FlipkartMorgan StanleyAmazonMicrosoftSnapdealOraclePayuVisaDirectiGreyOrangeMobicip
* Fractional Knapsack - gfg - Microsoft
* Knapsack with Duplicate Items - gfg - AmazonGoogle
377. Combination Sum IV - asked similar qn in gfg - Combination Sum - AmazonMicrosoftAdobe
* Get Minimum Squares - gfg - AmazonMicrosoftWipro
above LIKELY similar to bellow
279. Perfect Squares -  no question found in gfg
983. Minimum Cost For Tickets - no question found in gfg
983. Minimum Cost For Tickets - Part 2 (optimisation)
221. Maximal Square - AmazonSamsung
1824. Minimum Sideway Jumps - no quesiton in gfg 
1402. Reducing Dishes - no quesiton in gfg 
300. Longest Increasing Subsequence - PaytmAmazonMicrosoftOYO RoomsSamsungBankBazaar
TRY - 354. Russian Doll Envelopes - Hard - question not found
1691. Maximum Height by Stacking Cuboids - Hard - AmazonMicrosoftCodenation
1388. Pizza With 3n Slices - Hard - question not found
* need to code the tabuation approach
1155. Number of Dice Rolls With Target Sum - Medium - AmazonMicrosoft
* need to convert to leetcode - bellow qn
416. Partition Equal Subset Sum - Medium -  AccoliteAmazonMicrosoftOYO RoomsAdobeDrishti-Soft
801. Minimum Swaps To Make Sequences Increasing - Hard -  question not found
* need to convert to leetcode - bellow qn
1027. Longest Arithmetic Subsequence - Medium - mazonMicrosoftSnapdealGoogle
1218. Longest Arithmetic Subsequence of Given Difference - Medium - question not found
300. Longest Increasing Subsequence - Medium - PaytmAmazonMicrosoftOYO RoomsSamsungBankBazaar
96. Unique Binary Search Trees - Medium - AmazonMicrosoftSamsungTwitter
375. Guess Number Higher or Lower II - Medium - question not found
1130. Minimum Cost Tree From Leaf Values - Medium - question not found
121. Best Time to Buy and Sell Stock - Easy - PaytmFlipkartAccoliteAmazonMicrosoftD-E-ShawMakeMyTripOla CabsOracleWalmartGoldman SachsDirectiIntuitGoogleQuikrSalesforcePubmaticSapientSwiggyMedia.net
122. Best Time to Buy and Sell Stock II - Medium - question not found 
123. Best Time to Buy and Sell Stock III - Hard - question not found 
188. Best Time to Buy and Sell Stock IV - Hard -  question not found 
714. Best Time to Buy and Sell Stock with Transaction Fee - Medium -  tap of the question not found 
1143. Longest Common Subsequence - Medium - question not found 
516. Longest Palindromic Subsequence - Medium - question not found
////////////////////////////////////////////////////////////////////////////////


Minimum Cost Path - gfg - AmazonMicrosoftSamsungMakeMyTripGoldman Sachs
Minimum number of jumps - gfg - Moonfrog LabsFlipkartAmazonMicrosoftHousing.comWalmartAdobeGoogle
Longest Common Subsequence - gfg - PaytmVMWareAmazonMicrosoftCitrixMakeMyTrip